지플립일	NNP
지폴드일	NNP
지플립삼	NNP
지폴드삼	NNP
지플립사	NNP
지폴드사	NNP
플립	NNP
폴드	NNP
지플립 NNP
지폴드 NNP
갤럭시에스이십이	NNP
갤럭시에스이십일	NNP
갤럭시에스이십	NNP
갤럭시노트십	NNP
갤럭시노트이십	NNP
아이폰십삼	NNP
아이폰십삼프로	NNP
아이폰십삼프로맥스	NNP
아이폰십이	NNP
아이폰십이프로	NNP
아이폰십이프로맥스	NNP
에스펜	NNP
삼성페이	NNP
애플페이	NNP
기기 변경 욕구	NNP
움짤	NNP
언더디스플레이카메라	NNP
게임옵티마이징서비스	NNP
유기발광다이오드	NNP
주사율	NNP
미리암페어	NNP
아이패드	NNP
태블릿	NNP
폴더블폰	NNP
커버디스플레이	NNP
지문인식	NNG
멀티태스킹	NNG
비스포크	NNP
무선충전	NNP
교통카드	NNP
보조배터리	NNP
차별화	NNG
성능	NNG
휴대성	NNG
보호필름	NNG
역대급	NNG
톰브라운	NNP
완성도	NNG
자급제	NNP
존버	NNP
통화녹음	NNG
알뜰폰	NNP
고민	NNG
폴더블제품	NNP
애플워치	NNP
색깔	NNP
사전예약	NNG
